000000000000000
000010001000000
000111111100000
001111111110000
011101110111000
010111111101000
010010001001000
000110001100000
110111111111110
110110101111000
100110101110010
101110101100110
101110101101110
000000000000000
111111011111111
